1 0
#############################
#                           #
#                           #
#                           #
#                           #
#                           #
#            *              #
#            8              #
#                           #
#                           #
#                           #
#                           #
#                           #
#                           #
#                           #
#                           #
#                           #
#                           #
#                           #
#                           #
#############################