0 1  
#####################
#*8                 #       
#                   #       
#                   #       
#                   #       
#                   #       
#                   #
#####################